NO ./textures/north
SO ./textures/south
WE ./textures/west
EA ./textures/east

F 220,100,0
C 225,30,0

111111
100101
101001
1000N1
111111